B,B,B,B,B,B,B,B
B,0,0,0,0,M,0,B
B,0,0,0,0,0,0,B
B,0,0,0,0,0,0,B
B,0,0,0,0,0,C,B
B,0,0,0,0,0,0,B
B,0,0,0,0,0,0,B
B,B,B,B,B,B,B,B