B,B,B,E,B,B,B,B
B,0,0,0,0,0,2,B
B,0,1,0,0,0,0,B
B,0,1,1,0,3,0,B
B,0,0,1,1,3,2,B
B,1,0,2,0,2,0,B
B,1,0,0,1,0,0,B
B,B,B,B,B,B,B,B